15 15
###############
#     #       #
#     #   #####
#             #
#####         #
#             #
#      i     ##
#####         #
#             #
#       #######
#             #
#    #        #
#    # #      #
#             #
###############
13 12
############
# #      # #
# #      # #
###      ###
#      i   #
#          #
#  #    #  #
#  ## # #  #
#          #
#     #    #
#     #    #
#     #    #
############